chess
WBWBWBWB
BWBWBWBW
WBWBWBWB
BWBWBWBW
WBWBWBWB
BWBWBWBW
WBWBWBWB
BWBWBWBW

foursquare
WWWWBBBB
WWWWBBBB
WWWWBBBB
WWWWBBBB
BBBBWWWW
BBBBWWWW
BBBBWWWW
BBBBWWWW

kumite
WWWWWWWW
WBBBBBBW
WBBBBBBW
WBBWWBBW
WBBWWBBW
WBBBBBBW
WBBBBBBW
WWWWWWWW

zebra
WBWBWBWB
WBWBWBWB
WBWBWBWB
WBWBWBWB
WBWBWBWB
WBWBWBWB
WBWBWBWB
WBWBWBWB

whitecross
BBBWWBBB
BBBWWBBB
BBBWWBBB
WWWWWWWW
WWWWWWWW
BBBWWBBB
BBBWWBBB
BBBWWBBB
